type octile
height 13
width 15
map
........T......
.X......T......
........T......
...............
........T......
........T......
TTT.TTTTTTTTT.T
........T......
........T......
........T......
........T......
...............
........T.....G