type octile
height 13
width 15
map
...............
.X.............
...............
...............
...............
...............
...............
...............
...............
............G..
...............
...............
...............